#######################################
#                                     #
#                                     #
#               X                     #
#########                             #
#                                     #
#                            ##########
#                               O     #
#       X                    ##########
#                            ##########
#                                     #
#             P                       #
#                            O        #
#                                     #
#######################################
